#  ####  ###### ####
# ###     ##  #  ###
###    ########    #
#    ###            
#     #             
# ##############    
#         ##        
#      ########     
#  ########         
##################  
##############      
   #    ##   #      
########     ###$##
####   ####  ###   